blustering - talk in a loud, aggressive, or indignant way with little effect.

rip off - a fraud or swindle, especially something that is grossly overpriced (драть шкуру)

vow - swear, solemnly promise to do a specified thing, клясться

trace - find or discover by investigation.

hollowing out - опустошение, выхолащивание, выдалбливание

obsessed - preoccupy, одержим, озабоченн

rest of the world - остальной мир

prima facie - based on the first impression

raw end of the deal - несправедливая сделка.

turned to - обращаться к

backward - задом наперед

attorney  - юрист

commitment - обязательство

dries up - иссякать

urging - побуждать

wreaked - cause (a large amount of damage or harm)

havoc - опустошение

On top of that - Вдобавок ко всему

to the extent - в той мере

gutted - опустошить

swaths of - массы

sinister cycle - порочный круг

against a backdrop - на фоне, в условиях

profoundly - глубоко

disrupted - подорваны, нарушено, разрушенно

pummeled  - strike repeatedly with the fists.

herald - предвещать

substantial - существенный

adjustment - приспособление, регулировка

fearmongering -  нагнетание страха

besieged - surrounded by, осажден

calamity - бедствие

embracing - принять, обнять

mount - устанавливать

cumulative - совокупный

give up - сдаться, бросить, отказаться

compelling - убедительный

laying out - разработать

blue-collar -  рабочих, "синих воротничков"

tinge of anxiety - налет беспокойства

envision - воображать



pour - налить, flow rapidly in a steady stream.

along with - вместе с

Red Ink - Red ink is business jargon describing a financial loss.
Black Ink - a business profit or surplus

As a matter of - С точки зрения

subtract - вычесть

shrink - сокращаться

lash out - наброситься

presiding - be in the position of authority in a meeting or other gathering.

vis-àvis - по отношению к

and for this - за это, для этого

agenda - a list of items to be discussed at a formal meeting.

poster child - живой пример